TILEMAP
32 22 							-- Size of tile map in tiles
16 32 							-- Tile size & block size
images/blocks.png 	-- Tilesheet
2 2 								-- Number of tiles in tilesheet
11111111111111111111111111111111
11                            11
11                            11
11                            11
11                            11
11      3333333333333333      11
11            1111            11
11            1111            11
11    33333333111133333333    11
11            1111            11
11            1111            11
11  333333333311113333333333  11
11                            11
11                            11
11  3333                3333  11
11                            11
11                            11
11  33                    33  11
11                            11
11                            11
113333333333        333333333311
11111111111144444444111111111111

