TILEMAP
36 28 							-- Size of tile map in tiles
16 16 							-- Tile size & block size
images/bloques4.png 	-- Tilesheet
8 8 								-- Number of tiles in tilesheet
J                                  I
I                                  J
J                                  I
I                                  J
JIJIJIJIJIJIJIJIJIJIJIJIJIJIJIJIJIJI
I  J                            I  J
JIJI                            JIJI
IJIJ                            IJIJ
JIJI                            JIJI
IJIJ                            IJIJ
JIJI        455555555556        JIJI
IJIJ           EBBBBF           IJIJ
JIJI            EBBF            JIJI
IJIJ  456        EF             IJIJ
JIJI                            JIJI
IJIJ                            IJIJ
JIJI      456                 78JIJI
IJIJ                          ?@IJIJ
JIJI             456   455555555JIJI
IJIJ                     EBBBBBBIJIJ
JIJI        456             EBBBJIJI
IJIJ                           EIJIJ
JIJI                            JIJI
IJIJ555556                      IJIJ
JIJIBBBBBB5556                  JIJI
IJIJBBBBBBBBBC        4555555555IJIJ
JIJIJIJIJIJIJI55555555JIJIJIJIJIJIJI
IJIJIJIJIJIJIJIJIJIJIJIJIJIJIJIJIJIJ
